111111111111111111111111
100000000000000000000001
100000000000000000000001
100000000000000000000001
100000111110000101010001
100000100010000000000001
100000101010000100010001
100000100010000000000001
100000110110000101010001
100000000000000000000001
100000001000000000000001
100000000000000000000001
100000000000000000000001
100000000000001111111001
100000000000000000000001
100000000000000000000001
111111111000000000000001
100100001000000000000001
100000101000000000000001
100100001000000000000001
100111111000000000000001
100000000000000000000001
100000001000000000000001
111111111111111111111111
