1111111111111111111111111111
1001100111110000000000000001
1000000111110000000000000001
1000000100000000000000000001
1000000001110000000000000001
1001100111110000000000000001
1010000111110000000000000001
1111011111111111111111111111
1001000111110000000000000001
1000000000000000000000000001
1000000110110000000000000001
1000000110110000000000000001
1001100110110000000000000001
1010000110110000000000000001
1111111110111111001111111111
1001100110110000000000000001
1000000110110000000000000001
1000000110110000001000000001
1000000110110000001000000001
1001100000110000000000000001
1010000111110000000000000001
1111111111111111111111111111
