11111111
10011001
10000001
10000001
10000001
10011001
10100101
10000001
10000001
10000001
10000001
10000001
10000001
10000001
10000001
10000001
10011001
10100101
10100101
10100101
10100101
10000001
10000001
10000001
10000001
10000001
10000001
10000001
10000001
10000001
10000001
10000001
10000001
10000001
10000001
11111111
